+++++++++++++++++++
+0   +++     ++++++
+               +++
+                 +
+                A+
+               +a+
+++++++++++++++++++