+++++++++++++++++++++++++
+                       +
+0 ++++++++++++++++++++A+
+         A    +++++++ a+
+         A    ++++++++++
+         A    ++++++++++
+++++++++++++++++++++++++

HEY LUCA I DID THIS